################################################
#..............................................#
#..............................................#
#.............@................................#
#..............................................#
#..............................................#
#..............................................#
#..............................................#
#..............................................#
################################################
